9
187
1111111111111111111111111111111111111111111111111111111111111       111111111111111              111  11111111111111111111111111111111111111111   22111111111111111111111111111111111111111
333333     3   3   3           33        5   5   5       33  222  3    3   3        1111                5 5 5 5       333     3   3   3   3       11   3      333     3    3111111111133331
                                                             111                          1111                                                                              3311111111    1
                                                                                                                                                              111                5 5 5    1
                                                                                                                                                               5                          1
                                                                                                                                                                                          1
                                                                                       111                                                     111                                        1
  7      2   2   2    2222         2222    4   4   4         22      2   2                   11          4 4 4   22         2   2   2   2   4  333       222  4 4   2   2      4  4 4  6 21
11111111111111111111111111     11111111111111111111111111111111111111111111111111111            111 11111111111111111111111111111111111111111         1111111111111111111111111111111111111
